40 32
100 100
2 2 2 2 2 2 2 2 2 2 2 2 2 2 2 2 2 2 2 2 2 2 2 2 2 2 2 2 2 2 2 2 2 2 2 2 2 2 2 2
2 1 1 1 1 4 1 1 1 1 1 1 1 1 1 1 1 1 1 1 1 1 1 1 1 1 1 1 1 1 1 2 2 1 1 1 1 1 1 2
2 1 1 2 2 2 2 1 1 1 1 1 2 1 1 1 1 1 1 4 1 1 1 1 1 1 1 4 1 1 1 2 2 1 1 1 1 1 1 2
2 1 1 1 1 4 1 1 1 1 1 2 2 1 1 1 1 1 1 1 1 1 1 1 1 2 2 1 1 1 1 2 2 2 2 2 2 1 1 2
2 1 1 1 1 1 1 1 1 1 1 2 2 2 2 2 2 2 2 2 2 2 2 2 2 2 2 1 1 1 1 2 2 1 1 1 1 1 1 2
2 1 1 1 2 2 2 2 2 2 2 2 2 2 1 1 1 1 1 1 1 1 1 1 1 1 1 1 1 1 1 2 1 1 1 2 2 1 1 2
2 1 1 1 1 1 1 1 1 1 1 1 1 1 1 1 1 1 1 1 1 1 1 1 1 2 2 1 1 1 1 1 1 1 1 2 2 1 1 2
2 1 1 1 2 2 2 2 1 2 1 1 1 1 1 2 2 2 2 2 2 2 2 2 2 2 2 2 2 1 1 1 4 1 1 1 1 1 1 2
2 1 1 1 1 1 2 2 1 2 1 1 1 1 1 2 1 1 1 1 1 1 2 2 1 1 1 1 1 1 4 1 1 1 1 1 1 1 1 2
2 1 1 3 1 1 1 2 1 2 1 1 1 1 1 2 1 1 1 1 1 1 2 2 1 1 1 2 2 1 1 1 1 2 2 2 2 1 4 2
2 2 1 1 1 1 1 2 1 2 2 2 2 2 2 2 2 2 2 1 4 1 2 2 1 1 1 2 2 1 1 1 1 2 2 1 1 1 1 2
2 2 2 1 1 1 1 1 1 1 1 1 1 1 1 1 1 1 2 1 1 1 2 2 1 1 1 1 1 1 1 1 2 2 2 1 1 1 1 2
2 2 2 2 1 1 1 1 2 1 1 1 1 1 1 1 1 1 2 2 1 1 2 2 2 2 4 1 1 2 2 2 2 2 1 1 1 1 4 2
2 1 1 1 4 1 1 1 2 2 2 1 1 1 2 2 1 1 2 2 1 1 1 2 1 1 1 1 1 1 1 1 1 1 1 1 1 1 1 2
2 1 1 1 1 1 1 1 1 2 2 2 2 2 2 2 1 1 2 2 1 1 1 2 1 1 1 1 4 1 1 1 2 2 2 2 1 1 1 2
2 4 2 1 2 1 4 1 1 1 2 2 1 1 1 1 1 1 2 9 1 1 1 2 1 4 1 1 1 1 1 1 2 2 2 2 1 1 1 2
2 1 2 1 2 1 1 4 1 1 1 2 1 4 1 1 2 2 2 1 1 4 1 1 1 1 2 2 2 2 1 1 1 1 1 1 1 1 1 2
2 1 2 1 2 1 1 1 1 2 1 1 1 1 1 1 1 2 2 1 1 1 1 1 1 1 2 2 2 2 1 1 4 1 1 2 2 2 2 2
2 1 2 1 2 2 1 1 2 2 1 4 1 1 1 4 1 2 2 2 2 2 2 1 1 1 2 2 1 1 1 1 1 1 1 1 1 1 1 2
2 1 2 2 2 2 1 1 2 2 1 4 1 1 1 1 1 2 2 2 2 2 2 2 4 1 2 2 1 1 1 1 1 1 1 1 1 1 1 2
2 1 1 1 1 1 1 1 1 1 4 1 1 1 1 1 1 1 1 1 1 1 1 2 1 1 2 2 1 1 1 2 2 2 2 2 1 1 1 2
2 2 2 1 1 1 2 2 1 1 1 2 2 1 1 1 2 1 1 1 1 1 2 2 1 1 2 2 1 1 1 1 2 2 1 1 1 1 1 2
2 1 1 1 1 2 2 2 1 1 1 2 2 2 1 1 2 2 2 2 2 2 2 1 1 1 1 1 1 1 1 1 2 2 1 4 1 1 1 2
2 1 1 1 2 2 2 1 1 2 1 2 2 1 1 1 1 1 1 1 1 1 1 1 1 1 1 2 1 1 1 1 2 2 1 1 1 1 1 2
2 2 1 4 1 1 1 1 1 2 1 1 1 1 1 1 1 1 1 1 1 1 1 1 1 1 2 1 1 1 1 1 1 2 1 1 2 2 2 2
2 2 1 1 1 1 1 4 1 1 2 2 2 2 2 2 2 2 1 1 1 1 1 1 1 2 1 1 1 1 1 1 2 2 1 1 1 1 1 2
2 2 1 1 1 1 1 4 1 1 2 2 2 2 2 2 2 2 1 1 1 2 2 2 2 2 1 1 1 1 4 1 1 1 2 1 1 1 1 2
2 2 2 2 2 1 1 1 1 1 2 2 1 1 1 1 2 2 1 1 2 2 2 2 2 2 1 1 1 1 1 4 1 1 2 2 2 2 1 2
2 1 1 2 2 1 1 2 2 2 2 2 1 4 1 1 2 2 1 1 2 2 1 1 2 2 1 1 1 1 1 1 1 1 1 1 2 2 1 2
2 1 1 1 1 1 1 4 1 1 2 2 1 1 1 1 1 1 1 4 1 1 1 1 2 2 1 1 1 1 1 1 1 1 1 1 2 2 1 2 
2 1 1 1 4 1 1 1 1 1 2 2 1 1 1 1 4 1 1 1 1 1 1 2 2 2 2 2 1 1 1 1 1 1 1 1 2 2 1 2
2 2 2 2 2 2 2 2 2 2 2 2 2 2 2 2 2 2 2 2 2 2 2 2 2 2 2 2 2 2 2 2 2 2 2 2 2 2 2 2