20 20
150 600
2 2 2 2 2 2 2 2 2 2 2 2 2 2 2 2 2 2 2 2
2 1 1 1 1 4 1 1 1 1 1 1 1 1 1 1 1 1 1 2
2 1 1 2 2 2 2 1 1 1 1 1 1 1 1 1 1 1 1 2
2 1 1 1 1 4 1 1 1 1 1 1 1 1 1 1 1 1 1 2
2 1 1 1 1 1 1 1 1 1 1 1 1 1 1 1 1 1 1 2
2 1 1 1 2 2 2 2 1 1 1 1 1 1 1 1 1 1 1 2
2 1 1 1 1 1 1 1 1 1 1 1 1 1 1 2 2 2 2 2
2 1 1 1 2 2 2 2 1 2 1 1 1 1 1 2 1 1 1 2
2 1 1 1 1 1 2 2 1 2 1 1 1 1 1 2 1 1 1 2
2 1 1 3 1 2 1 2 1 2 1 1 1 1 1 2 1 1 1 2
2 1 1 1 1 1 1 2 1 2 2 2 2 2 2 2 1 1 1 2
2 1 1 1 1 1 1 1 1 1 1 1 1 1 1 1 1 1 1 2
2 1 1 1 1 1 1 1 1 1 1 1 1 1 1 1 1 1 1 2
2 1 1 1 4 1 1 1 1 1 1 1 1 1 1 1 1 1 1 2
2 1 1 1 1 1 1 1 1 1 1 1 1 1 1 1 1 1 1 2
2 1 1 1 1 1 1 1 1 1 1 1 1 1 1 1 1 1 1 9
2 1 1 1 1 1 1 1 1 1 1 1 1 1 1 1 1 1 1 2
2 1 1 1 1 1 1 1 1 1 1 1 1 1 1 1 1 1 1 2
2 1 1 1 1 1 1 1 1 1 1 1 1 1 1 1 1 1 1 2
2 2 2 2 2 2 2 2 2 2 2 2 2 2 2 2 2 2 2 2